#####################
#s# #   #     #   # #
# # # # # ####### # #
# #   #       # # # #
# ##### # ### # # # #
# # #   #   # #     #
# # # ####### # # ###
#     #     #   #   #
### # ### ### ##### #
#   # #         #  e#
#####################
