###############################
#s#   #   # #   #       #     #
# # ### ### ### # # # # # ### #
# #     # #       # # #     # #
# ##### # ########### ### ### #
#           #       #   #   # #
##### ########### ######### ###
# #   #       #       #       #
# # ####### ### # ### # ### # #
#       #     # # # #   # # # #
####### # # ####### ### # # # #
# # # #   #   # #         # # #
# # # # ### ### # ##### #######
# #       # #   # #   #     # #
# ##### ####### # ### ### ### #
#     #   #   #   #   #       #
### ##### # ### ### ### # # # #
#           #     #     # # # #
# ### ##### # ### ########### #
# #   #       #             #e#
###############################
