#####################################################################################################################################################################################
#s#       #     # # #   # #     #       #     #       # #   #   # #         #       #       # # # # #     # #       #   # #   #       # # # #     # # # #       #   # #   #     #   #
# ##### # # ##### # ### # # ######### # # # ######### # ### # ### # # ### # # ####### ### ### # # # # ##### ### ####### # ### ### ##### # # ##### # # # # # ### # ### # # ### # # ###
# # #   #     # #   # #   # #   #   # # # # #   #     #     #   #   #   # #   #     # # #   #   #       # #       #       # #   #     #       #       #   # #   #   #   #   # # #   #
# # ### # ### # # ### # ### # ##### ### # # # ### # ### # ##### # # ######### ### # ### # ##### # # ##### ####### # ### ### # ### # ### ##### ####### ### ### # # ### ##### # ##### #
#       # #     #     #             #   # # # #   # #   #   #   # #     # #       # #         #   # # #     #   #   # #     # # # #       #         #   # #   #       # #       #   #
# ##### # # ### # # ### ##### # ####### # # # ### # # ######### # # ### # # # ### # # ##### ##### ### # ##### # ##### # ##### # ####### ### # ### ### ##### ####### ### ### ##### ###
# #   # # # #     #         # #   # # # # #     # #   # # #       #   # # # #   # # # #   #     #   #       # #   #             #   #   #   # #       # #   #         #             #
### # # # ### ##### ### ####### ### # # ##### # ### # # # ### # ######### ### # ### ### ### ### ### # # ### ### ### ### ####### # ### ### # # # ### ### # ##### ######### ###########
#   #   # # #   #     # # #   #         # #   #     #   #   # #   #     # #   # #       #   #   #     # #             #   #   #         # # # #   #   #   #   #       #     # # #   #
### ### ### # ### ####### # # # ### # # # # ##### ##### # ##### # # # ### ### ####### ######### # # ### ### # ####### ####### # # ######### ####### ##### ### ######### # # # # ### #
#     # #   # #   #   #     #     # # #   # #       # #       # # # # #     #   #     #   # # # # #   # #   # # # #   #   #     # #     # #     #   # # #   # #         # #       # #
### # ### # # ##### ##### ### ########### # # ### ### ##### # ### # # # ##### ####### # ### # # # ######### ### # ##### # ### ####### # # ####### ### # # # # # ### # ######### # # #
#   # #   #     #   #     # # #     # # #   #   #   #       #   #   #     # #     #   #   #             # #         # # # #         # #     #           # #   # #   # #     #   #   #
# # ### # ####### ##### ### ####### # # ### ### ####### # ### ######### ### # ######### ### ### # # ### # ####### ### # ### ##### ##### ##### ### # ##### ##### ####### # # ### # ###
# # #   # # #                 # # #         #     #   # # #   #     #   #   #   #         # #   # #   #   #     #     #     # # #       #   #   # #       # #   #     # # #   # #   #
##### ##### ##### ### # ### # # # ####### # # ##### ##### ####### ##### # ### ### ### ####### ####### ### # # # # ### # ##### # ### # ### # # # ##### ### # # ####### # # ####### ###
#         # #       # # # # #   #   #   # # #     #   # #     # #   #   #   #   # #   #   #       # #   # # # #     # #         #   # #   # # # #       # # # # #   #   #   #   #   #
# ##### ### # # ### # # # # ##### # ### # ### ##### ### # ### # # # # ### # # # ### ##### ### # ### # ### # # ### ##### ##### ### ### # ##### ### # # ### # # # # ### ##### # ### # #
# #       #   #   # # # #         # #       #   #           #     #       # # #               #     # #   # #   #   #     #     #   #     #     # # # #   #       #     #         #e#
#####################################################################################################################################################################################
