#############
#s          #
########### #
#          e#
#############
