#####################
#s    #   # #       #
# ### ### # ### #####
# #                 #
##### # ####### ### #
# #   #   # # # # # #
# ####### # # # # ###
# #   #     #       #
# ### ### ### ##### #
#           #   #  e#
#####################
