#####################
#s....#   # #       #
# ###.### # ### #####
# #  ...........    #
##### # #######.### #
# #   #   # # #.# # #
# ####### # # #.# ###
# #   #     #  .....#
# ### ### ### #####.#
#           #   #  e#
#####################
