#####################################################################################################################################################################################
#s#    ...#     # # #   # #     #       #     #       # #   #   # #.........#       #       # # # # #     # #       #   # #   #       # # # #     # # # #       #   # #...#     #   #
#.#####.#.# ##### # ### # # ######### # # # ######### # ### # ### #.# ### #.# ####### ### ### # # # # ##### ### ####### # ### ### ##### # # ##### # # # # # ### # ### #.#.### # # ###
#.# #  .#.....# #   # #   # #   #   # # # # #   #     #     #   #...#   # #...#     # # #   #   #       # #       #       # #   #     #.......#       #   # #...#   #...#...# # #   #
#.# ###.# ###.# # ### # ### # ##### ### # # # ### # ### # ##### #.# #########.### # ### # ##### # # ##### ####### # ### ### # ### # ###.#####.####### ### ###.#.# ###.#####.# ##### #
#.......# #  ...#...  #.........    #   # # # #   # #   #   #   #.#     # #  .    # #         #   # # #     #   #   # #     # # # #    .  #  .....  #   # #...#.......# #  .    #   #
# ##### # # ###.#.#.###.##### #.####### # # # ### # # ######### #.# ### # # #.### # # ##### ##### ### # ##### # ##### # ##### # #######.### # ###.### #####.####### ### ###.##### ###
# #   # # # #  ...#.....    # #.  # # # # #  ...# #...# # #    ...#   # # # #.  # # # #   #     #   #.......# #   #.............#   #...#   # #  ...  # #...#         #  ...        #
### # # # ### ##### ### #######.### # # #####.#.###.#.# # ### #.######### ###.# ### ### ### ### ### #.# ###.### ###.### #######.# ###.### # # # ###.### #.##### #########.###########
#   #   # # #   #     # # #   #.........# #...#.....#...#   # #...#...  # #  .# #       #   #   #.....# #  .........  #   #   #.......  # # # #   #.  #  .#   #       #  ...# # #   #
### ### ### # ### ####### # # # ### # #.# #.##### #####.# ##### #.#.#.### ###.####### ######### #.# ### ### # ####### ####### # # ######### #######.#####.### ######### # #.# # ### #
#     # #   # #   #   #     #     # # #...#.#       # #.....  # #.#.#.#     #.  #     #   # # # #.#   # #   # # # #   #   #     # #     # #     #...# # #.  # #         # #.......# #
### # ### # # ##### ##### ### ###########.#.# ### ### #####.# ###.#.#.# #####.####### # ### # # #.######### ### # ##### # ### ####### # # #######.### # #.# # # ### # ######### #.# #
#   # #   #     #   #     # # #     # # #...#   #   #    ...#   #...#...  # #.    #   #   #    ...      # #         # # # #         # #     #    ...    #.#   # #   # #     #   #.  #
# # ### # ####### ##### ### ####### # # ### ### ####### #.### #########.### #.######### ### ###.# # ### # ####### ### # ### ##### ##### ##### ### #.#####.##### ####### # # ### #.###
# # #   # # #                 # # #         #     #   # #.#   #     #  .#   #.  #         # #...# #   #   #     #     #     # # #       #   #   # #.......# #   #     # # #   # #.  #
##### ##### ##### ### # ### # # # ####### # # ##### #####.####### #####.# ###.### ### #######.####### ### # # # # ### # ##### # ### # ### # # # ##### ### # # ####### # # #######.###
#         # #       # # # # #   #   #   # # #     #   # #.....# #...#...#   #...# #   #   #  .    # #   # # # #     # #         #   # #   # # # #       # # # # #   #   #   #   #...#
# ##### ### # # ### # # # # ##### # ### # ### ##### ### # ###.# #.#.#.### # # #.### ##### ###.# ### # ### # # ### ##### ##### ### ### # ##### ### # # ### # # # # ### ##### # ### #.#
# #       #   #   # # # #         # #       #   #           #.....#...    # # #...............#     # #   # #   #   #     #     #   #     #     # # # #   #       #     #         #e#
#####################################################################################################################################################################################
