#####################
#s# #   #     #   # #
#.# # # # ####### # #
#.#   #.......# # # #
#.#####.# ###.# # # #
#.# #...#   #.#...  #
#.# #.#######.#.#.###
#.....#     #...#...#
### # ### ### #####.#
#   # #         #  e#
#####################
