#####################
#s..#   # #         #
###.### # ##### #####
#  .# #  ...#   # # #
# #.# ###.#.# # # # #
# #.#.....#.# #.....#
###.#.# ###.###.###.#
#  .#.#   #.....#  .#
# #.#.# ####### ###.#
# #...# #         #e#
#####################
