###############################
#s#   #   # #   #       #     #
#.# ### ### ### # # # # # ### #
#.#     # #       # # #     # #
#.##### # ########### ### ### #
#.....      #       #   #   # #
#####.########### ######### ###
# #...#       #       #       #
# #.####### ### # ### # ### # #
#  .....#     # # # #   # # # #
#######.# # ####### ### # # # #
# # # #.  #   # #.......  # # #
# # # #.### ### #.#####.#######
# #    .  # #   #.#   #...  # #
# #####.####### #.### ###.### #
#     #...#   #...#   #  .....#
### #####.# ###.### ### # # #.#
#        ...#...  #     # # #.#
# ### #####.#.### ###########.#
# #   #    ...#             #e#
###############################
