#############
#s..........#
###########.#
#          e#
#############
